=====#=====
=#########=
=#@#####@#=
=#@@###@@#=
=###@#@###=
=#########=
=###@#@###=
=#@@###@@#=
=#@#####@#=
=#########=
=====#=====
